
minerals	
pills	
pollution	
limonol	deoxy- limonol,deoxy-alpha-limonol,
youth	
tea	
twins	
sprouting	
goji	lycium barbarum,goji berry plant,plant, berry,plants, berry,goji berry plants,goji plant,goji plants,wolfberry,wolfberries,goji berry,goji berries,goji berry,goji berries,lycium chinense,
angiogram	angiographies,angiogram,angiograms,arteriography,arteriographies,
energy	
nightshades	
cdc	
meats	
polymyositis	
ibuprofen	
hemlock	
asparagus	
wine	
czechoslovakia	
gmo	
bokhoor	
gold	
tmao	
bugs	
parsley	
myeloma	
citruline	cit-nh2,ala-parafluorophe-arg-cyclohexylala-citruline-tyr-nh2,
lameness	
hershey's	
glucose	
salt	
cows	
metformin	
blood	
flomax	5-(2-((2-(2-ethoxyphenoxy)ethyl)amino)propyl)-2-methoxybenzenesulfonamide,ly 253352,ly-253352,ym 617,ym-617,flomax,tamsulosin hydrochloride,
americans	
m&m's	
norway	
pfizer	
surgery	
rapamycin	
pigs	
pregnanacy	
antiperspirant	
hypoxia	
phytates	
polonium	
anthrax	
matcha	
peppermint	
marjoram	origanum vulgare,oregano plant,oregano plants,oregano plant,oregano plants,origanum onites,origanum majorana,marjoram plant,marjoram plants,marjoram plant,marjoram plants,sweet marjoram,sweet marjoram,sweet marjorams,sweet marjorams,majorana hortensis,oregano,oreganos,marjoram,marjorams,
vaseline	
allergies	
tempeh	
germany	
crowberries	
post-surgery	vasoplegias,postoperative vasoplegic syndrome,vasoplegic syndrome,post-operative vasoplegic syndrome,post operative vasoplegic syndrome,post-operative vasoplegic syndromes,post-operative syndrome,post-operative syndromes,syndrome, vasoplegic,syndromes, vasoplegic,
pcb	
steaming	
caffeine	
peas	
denmark	
xenoestrogens	p-octylphenol,4-octylphenol potassium,4-octylphenol barium,4-octylphenol sodium,
ativan	ativan,baxter brand of lorazepam,lorazepam baxter brand,wyeth brand of lorazepam,lorazepam wyeth brand,t√©mesta,orfidal wyeth,orfidal wyeth,donix,llorens brand of lorazepam,lorazepam llorens brand,duralozam,merck dura brand of lorazepam,durazolam,idalprem,novartis brand of lorazepam,lorazepam novartis brand,laubeel,desitin brand of lorazepam,lorazepam desitin brand,lorazep von ct,ct-arzneimittel brand of lorazepam,lorazepam ct-arzneimittel brand,ct arzneimittel brand of lorazepam,lorazepam medical,lorazepam medical,medical brand of lorazepam,lorazepam medical brand,lorazepam-neuraxpharm,lorazepam neuraxpharm,neuraxpharm brand of lorazepam,lorazepam neuraxpharm brand,lorazepam-ratiopharm,lorazepam ratiopharm,ratiopharm brand of lorazepam,lorazepam ratiopharm brand,novo-lorazem,novo lorazem,novolorazem,novopharm brand of lorazepam,lorazepam novopharm brand,nu-loraz,nu loraz,nuloraz,nu-pharm brand of lorazepam,lorazepam nu-pharm brand,nu pharm brand of lorazepam,sedicepan,serra pamies brand of lorazepam,sinestron,medix brand of lorazepam,lorazepam medix brand,somagerol,riemser brand of lorazepam,lorazepam riemser brand,temesta,ahp brand of lorazepam,lorazepam ahp brand,tolid,dolorgiet brand of lorazepam,lorazepam dolorgiet brand,wy-4036,wy 4036,wy4036,apo-lorazepam,apo lorazepam,apolorazepam,apotex brand of lorazepam,lorazepam apotex brand,
salami	
xylitol	
cellulite	cellulites,
glyphosate	
filberts	filbert,filberts,hazelnuts,hazelnut,
mastitis	
barbeque	
trimethylamine-n-oxide	
avocados	perseas,persea americana,persea americanas,persea americana,avocado,avocados,
evolution	
china	
coffee	
pediatrics	
overeating	overeating,polyphagia,polyphagias,
cancer	
anchovies	
bismuth	
c-section	cesarean sections,abdominal delivery,abdominal deliveries,abdominal deliveries,caesarean section,caesarean sections,abdominal delivery,c-section (ob),c section (ob),c-sections (ob),postcesarean section,
cannibalism	
lifespan	
rutin	
xanthones	
bergamots	
tremors	
fiber	
africa	
period	
infants	
cytoskeleton	
angiogenesis	
cgmp	
geico	
indonesia	
lumpectomy	segmental mastectomies,segmental mastectomies,segmental mastectomy,local excision mastectomy,local excision mastectomies,local mastectomies,local mastectomy,segmentectomy,segmentectomies,partial mastectomy,partial mastectomies,partial mastectomy,partial mastectomies,limited resection mastectomy,limited resection mastectomies,limited mastectomies,limited mastectomy,lumpectomy,lumpectomies,breast-conserving surgery,breast conserving surgery,breast quadrantectomy,breast quadrantectomies,breast quadrantectomies,breast quadrantectomy,breast-conserving surgery,breast-conserving surgeries,breast-conserving surgeries,breast surgery,breast conservation therapy,breast conservation therapies,therapies, conservation,therapy, conservation,breast-sparing surgery,breast sparing surgery,breast-sparing surgeries,breast-sparing surgeries,breast-sparing surgery,
intelligence	
mutation	
toxins	
women	
penicillin	
gut	
obama	
sausages	
soybeans	
syndrome	
tor	
pain-killers	
antiangiogenesis	
glucoraphanin	
paratuberculosis	
drugs	
vinegar	
asian	
cheap	
agave	agaves,maguey,magueys,century plant,century plants,century plant,century plants,
produce	
cod	
nutmeg	myristica fragran,myristica fragran,nutmeg,nutmegs,
bacteria	
bmaa	
flora	
marijuana	
nitrites	
pie	
tegaserod	
iatrogenic	
kidney	
microwaving	
pin	
yersinia	
puberty	
spermidine	
formaldehyde	
anthocyanins	
basil	
flavoring	
taurine	
herbivore	herbivories,herbivore,herbivores,animal grazing,animal grazings,animal grazing,animal grazings,
margarine	
christmas	
dannon	
buckwheat	
gout	
glucosinolates	
cadmium	
hexachlorobenzene	
metabolism	
calendula	
probiotics	probiotic,
chicken	
fibroadenomas	fibroadenomas,
fruit	
glucophage	dimethylbiguanidine,dimethylguanylguanidine,glucophage,metformin hydrochloride,metformin hydrochloride,metformin hcl,metformin hcl,
amylase	
sorrel	
genetics	
salads	
chlorination	chlorination,iodination,iodation,bromination,fluorination,
colonoscopy	
cholera	
garlic	
nuremburg	
pharmacists	
phytonutrients	phytonutrient,dietary phytochemicals,dietary phytochemicals,phytonutrients,plant-derived compounds,plant-derived compounds,plant derived compounds,phytochemical,plant-derived chemicals,plant-derived chemicals,plant derived chemicals,
oregano	origanum vulgare,oregano plant,oregano plants,oregano plant,oregano plants,origanum onites,origanum majorana,marjoram plant,marjoram plants,marjoram plant,marjoram plants,sweet marjoram,sweet marjoram,sweet marjorams,sweet marjorams,majorana hortensis,oregano,oreganos,marjoram,marjorams,
jaundice	
citrus	
lentils	
saliva	
burning	
ldl	
lamb	
impatience	
esophagus	
herbalife	
saccharin	
satiety	
acrylamide	
japan	
syncope	
flaxseeds	
teenagers	adolescents,adolescence,teens,teen,teenagers,teenager,youth,youths,female adolescents,female adolescent,female adolescent,female adolescents,male adolescents,male adolescent,male adolescent,male adolescents,
oncology	
goiter	
medications	
decaf	
pms	
philippines	
bible	
almond	
casein	
melanoma	
canola	
tvp	
myplate	
creatine	
gargling	
scallions	
aluminum	
masculinity	
celery	
lard	
fibromyalgia	
hydroxycut	
micronase	glybenclamide,glibenclamide,diabeta,euglucon 5,neogluconin,hb-419,hb 419,hb419,hb-420,hb 420,hb420,maninil,micronase,daonil,euglucon n,
pomegranates	pomegranate,pomegranates,punica granatum,punica granatums,punica granatum,
digestion	
talapia	
espresso	
saoott	
fainting	
lignans	
holotranscobalamin	
marketing	
a1c	
paprika	bell pepper,bell peppers,bell pepper,bell peppers,sweet pepper,sweet pepper,sweet peppers,sweet peppers,red pepper,red pepper,red peppers,red peppers,green pepper,green peppers,green pepper,green peppers,cayenne pepper,cayenne peppers,cayenne pepper,cayenne peppers,cayenne,paprika,hot pepper,hot peppers,hot pepper,hot peppers,jalapeno pepper,jalapeno peppers,jalapeno pepper,jalapeno peppers,pimiento,capsicum annuum,chilli pepper,chilli peppers,chilli pepper,chilli peppers,chile pepper,chile peppers,chile pepper,chile peppers,chili pepper,chili peppers,chili pepper,chili peppers,
dopamine	
bison	bisons,american buffaloes,american buffaloes,american buffalo,american buffalo,
carbs	
polypill	
caucasian	whites,white,caucasoid race,caucasoid races,caucasoid race,caucasoid races,caucasian race,caucasian races,caucasian race,caucasian races,
l-dopa	
fosamax	aminohydroxybutane bisphosphonate,aminohydroxybutane bisphosphonate,1,1-biphosphonate 4-amino-1-hydroxybutylidene,amino 4,alendronate sodium,alendronate sodium,monosodium alendronate,fosamax,mk-217,mk 217,mk217,
campylobacter	
deception	false allegations,false allegation,false allegations,false allegation,hoax,lying,
holidays	holiday,festivals,festival,
ham	
dwarfism	
dogs	
cramping	
imitrex	
molasses	
plantains	
athletes	
supplements	
toxaphene	polychlorocamphene,
incontinence	
psa	
pepper	
memory	
pecans	caryas,hickory tree,hickory trees,hickory tree,hickory trees,pecans,pecan,hickory nuts,hickory nut,hickory nut,hickory nuts,carya illinoensis,carya illinoenses,carya illinoenses,pecan tree,pecan trees,pecan tree,pecan trees,
antioxidants	
teff	eragrosti,teff,teffs,
farmers	
hydroponic	hydroponic,
updates	stomatology,oral medicine,
vegetables	
fisitin	
agriculture	
metastases	
yanomamo	
currants	
hibiscus	
walnuts	
stari	
slovenia	
antiseptic	
care2	
pain	
calcium	
disease	
pth	
pepsi	
cucumbers	
orgasm	orgasms,sexual satisfaction,sexual satisfaction,sexual satisfactions,sexual satisfactions,sexual gratification,sexual gratification,sexual gratifications,sexual gratifications,
albumin	
antihistamines	
hiv/aids	
turmeric	
prostate	
aorta	
medicare	
pets	
plums	
cabbage	
smoothies	
cytoprotectant	
legumes	
pus	pus,
sciatica	
nanoparticles	
sweden	
agaritine	
phthalates	
vomiting	emesis,
curcumin	
dialysis	
vaginosis	
flowers	
magnesium	
dates	
glyconutrients	
esselstyn	
broccomax	
antibiotics	
collards	broccoli,brussel sprout,kale,cauliflower,collard green,collard greens,cabbage,cabbages,
infection	
naphthalene	
fisetin	3,3',4',7-tetrahydroxyflavone,5-desoxy-quercetin,3,3',4',7-tetrahydroxy-flavone,fisetinidin,
carotenoid	
trigylcerides	
tomatoes	
hirsutism	
panama	
lox	
norovirus	noroviruses,norwalk-like viruses,norwalk like viruses,small round-structured viruses,viruses, round-structured,small round structured viruses,
limonin	obaculactone,7,16-dioxo-7,16-dideoxylimondiol,
coriander	
lethicin	
ipecac	syrup of ipecac,ipecac syrup,ipecac (syrup),
oysters	
bagels	
gallstones	
subsidies	
coconuts	
travel	
diabetes	
stomach	
luteolin	
squash	
prunes	
bilberries	vaccinium bracteatum,vaccinium bracteatums,vaccinium bracteatum,vaccinium bracteatums,sea bilberry,sea bilberries,sea bilberry,sea bilberries,bilberry,bilberries,whortleberry,whortleberries,
cloves	
water	
quinine	
hydration	
halibut	flounders,plaice,pleuronectes platessa,pleuronectes,pseudopleuronectes,halibut,platichthys,
raisins	vitis vinifera,grapes,grape,raisins,raisin,
apples	
oxalates	
triphala	
kidneys	
edamame	
pesticides	
african-american	african americans,
dietitians	nutritionist,dieticians,dietician,dietitians,dietitian,
lactescence	
chemo	
herbal	
toxoplasma	
soda	
ddt	
meat	
wheatgrass	agropyrons,
tonga	
gooseberries	
erythritol	
reductionism	
gluten	
suppositories	
hypercapnia	
beef	
des	
chia	
mothers	
dental	
pomegranate	pomegranate,pomegranates,punica granatum,punica granatums,punica granatum,
beer	beers,
prevention	
listeria	
shock	
milk	
paralysis	
bile	
cortisol	
nitrite	
dulse	
enterococcus	
zoloft	zoloft,altruline,lustral,apo-sertraline,apo sertraline,aremis,besitran,sealdin,gladem,novo-sertraline,novo sertraline,ratio-sertraline,ratio sertraline,rhoxal-sertraline,rhoxal sertraline,sertraline hydrochloride,sertraline hydrochloride,sertraline hydrochloride (1s-cis)-isomer,gen-sertraline,gen sertraline,
oceans	
treatment	
galactosemia	galactosemia,galactose-1-phosphate uridyl-transferase deficiency disease,galactose 1 phosphate uridyl transferase deficiency disease,disease, deficiency,disease, deficiency,epimerase deficiency galactosemia,galactosemia, deficiency,galactosemias, deficiency,epimerase deficiency galactosemias,epimerase galactosemia,epimerase galactosemias,galactose-1-phosphate uridyltransferase deficiency,galactose-1-phosphate deficiencies,galactose-1-phosphate deficiency,galactose 1 phosphate uridyltransferase deficiency,galactose-1-phosphate uridyltransferase deficiencies,deficiencies, uridyltransferase,deficiency, uridyltransferase,utp-hexose-1-phosphate uridylyltransferase deficiency disease,utp hexose 1 phosphate uridylyltransferase deficiency disease,classic galactosemia,galt deficiency,galt deficiencies,galt deficiency,galt deficiencies,udpglucose hexose-1-phosphate uridylyltransferase deficiency,udpglucose hexose 1 phosphate uridylyltransferase deficiency,utp hexose-1-phosphate uridylyltransferase deficiency,utp hexose 1 phosphate uridylyltransferase deficiency,classic galactosemia,classic galactosemias,classic galactosemias,galactose-1-phosphate uridylyltransferase deficiency,galactose-1-phosphate deficiencies,galactose-1-phosphate deficiency,galactose 1 phosphate uridylyltransferase deficiency,galactose-1-phosphate uridylyltransferase deficiencies,deficiencies, uridylyltransferase,deficiency, uridylyltransferase,udpglucose 4-epimerase deficiency disease,udpglucose 4 epimerase deficiency disease,disease, deficiency,disease, deficiency,galactose epimerase deficiency,galactose deficiencies,galactose deficiency,galactose epimerase deficiencies,udp-galactose-4-epimerase deficiency disease,udp galactose 4 epimerase deficiency disease,galactosemia iii,galactosemia iiis,gale deficiency,gale deficiencies,gale deficiency,gale deficiencies,udp-galactose-4-epimerase deficiency,udp-galactose-4-epimerase deficiencies,udp-galactose-4-epimerase deficiency,udp galactose 4 epimerase deficiency,udp-galactose-4-epimerase deficiencies,disease, deficiency,disease, deficiency,diseases, deficiency,udp-galactose-4-epimerase deficiency diseases,galactosemia 3,galactosemia 3s,galactokinase deficiency disease,galactokinase deficiency diseases,hereditary galactokinase deficiency,hereditary deficiencies,hereditary deficiency,deficiencies, galactokinase,deficiency, galactokinase,hereditary galactokinase deficiencies,galactosemia 2,galactosemia 2s,galk deficiency,galk deficiencies,galk deficiency,galk deficiencies,disease, deficiency,galactokinase deficiency,galactokinase deficiencies,galactokinase deficiency,galactokinase deficiencies,
ethnicity	
cholecystokinin	
colchicine	
oatmeal	
keriorrhea	
liquor	
ruminococcus	
mint	
maggots	
vegans	
hearing	
maspin	serpinb5 protein,maspin,protein, serpinb5,protein, spi7,inhibitor protease,(or serine,protein, maspin,protein, ovalbumin,protein, serpinb5,protein, pi5,protein, maspin,(or serine,protein, serpinb5,(or serine,inhibitor protease,protein, maspin,protein, pi5,
dha	
allopurinol	
chafing	
migraine	
testosterone	
cesium	
fenugreek	
betadine	povidone iodine,povidone-iodines,pvp-i,pvp-iodine,pvp iodine,pvp-iodines,polyvinylpyrrolidone iodine,polyvinylpyrrolidone iodines,betadine,betadines,providine,providines,disadine,disadines,isodine,isodines,pharmadine,pharmadines,alphadine,alphadines,huntington laboratories brand of povidone-iodine,huntington laboratories brand of povidone iodine,betaisodona,betaisodonas,
amaranth	
amnesia	
indoles	
canthaxanthines	canthaxanthine,roxanthin red 10,food orange 8,orobronze,c.i. 40850,carophyll red,
flavonols	
aging	
treadmill	exercise tests,exercise test,exercise tests,arm ergometry test,arm ergometry tests,test, ergometry,tests, ergometry,arm test,arm tests,bicycle ergometry test,bicycle ergometry tests,test, ergometry,tests, ergometry,bicycle test,bicycle tests,fitness testing,fitness testings,fitness testing,fitness testings,step test,step tests,step test,step tests,stress test,stress tests,stress test,stress tests,treadmill test,treadmill test,treadmill tests,treadmill tests,physical fitness testing,testing, fitness,testings, fitness,physical fitness testings,physical testing,physical testings,cardiopulmonary exercise test,cardiopulmonary exercise tests,test, exercise,tests, exercise,cardiopulmonary test,cardiopulmonary tests,
meningioma	
maltodextrin	
arkansas	
xenohormesis	
urethra	
marshmallows	althaeas,althaea officinalis,marsh mallow,marsh mallows,marsh mallows,althea officinalis,white mallow,white mallow,white mallows,white mallows,marsh mallow,marshmallow,marshmallows,
dandelion	dandelion,dandelions,taraxacum officinale,
chinese	
radishes	
hiroshima	carbonic anhydrase isoenzyme b,carbonic anhydrase b,b, anhydrase,ca i hiroshima-1,ca i hiroshima 1,carbonic anhydrase i hiroshima-1,carbonic anhydrase i hiroshima 1,
seals	
livestock	livestocks,
thiamine	
ssri‚Äôs	
postmenopause	postmenopausal period,postmenopausal period,post-menopause,post menopause,post-menopauses,post-menopausal period,post-menopausal period,post menopausal period,
anise	
psyllium	
b-cells	
microbiome	
sodium	
vision	
rosemary	
methionine	
fluorosis	dental fluoroses,dental fluoroses,dental fluorosis,mottled enamel,mottled enamel,mottled enamels,mottled enamels,
figs	
influenza	
purevia	
cinnamon	
sunchokes	
bach	
miso	
berries	
malaysia	federation of malaya,malaya,malay federation,malaya federation,sabah,sarawak,malay peninsula,
spoilage	
trimethylamine	
lipotropes	
prolactin	
asia	
ecstasy	methyl n,mdma,methylenedioxymethamphetamine,ecstasy (drug),hydrochloride n-methyl-34-methylenedioxyamphetamine,n-methyl-3,4-methylenedioxyamphetamine hydrochloride,methyl n,
meta-analysis	
heartburn	pyrosis,pyroses,
insomnia	
dramamine	diphenhydramine theoclate,diphenhydramine theoclate,wehamine,aviomarin,biodramina,calm-x,calm x,cinfamar,contramareo,dimen heumann,dimen heumann,dimen lichtenstein,dimen lichtenstein,dimetabs,dinate,dmh,dramanate,gravol,marmine,motion-aid,motion aid,nausicalm,reisegold,reisetabletten l√ºnopharm,reisetabletten l√ºnopharm,reisetabletten stada,reisetabletten stada,reisetabletten-ratiopharm,reisetabletten ratiopharm,rodovan,rubiemen,superpep,travel well,triptone,vertigo-vomex,vertigo vomex,vomex a,vomacur,vomisin,dramamine,apo-dimenhydrinate,apo dimenhydrinate,
lemonin	
baby	
iron	
prostatectomy	
hypertension	
vaccinations	
bacteriophages	
chemotherapy	
tahini	
itching	
dna	
lying	
constipation	dyschezia,colonic inertia,
beverages	
dnp	
greta	
cream	
retinopathy	
purslane	portulacas,portulaca oleracea,portulaca oleraceas,portulaca oleraceas,purslane,purslanes,portulaca oleracae,
okra	
contaminants	
mycotoxins	
skin	
coleslaw	
cadium	
giantism	pituitary gigantism,pituitary gigantism,
taro	
tryptophan	
nigeria	
listerine	
health	
triglycerides	
hamburgers	
ritalin	metadate,celltech brand of methylphenidate hydrochloride,equasym,methylin,mallinckrodt brand of methylphenidate hydrochloride,concerta,phenidylate,ritalin,novartis brand 1 of methylphenidate hydrochloride,cephalon brand of methylphenidate hydrochloride,ritaline,ritalin-sr,ritalin sr,novartis brand 2 of methylphenidate hydrochloride,tsentedrin,centedrin,daytrana,methylphenidate hydrochloride,methylphenidate hydrochloride,
singapore	
microdialysis	
genitalia	
toxicants	
sigmoidoscopy	sigmoidoscopies,proctosigmoidoscopy,proctosigmoidoscopies,sigmoidoscopic surgical procedures,sigmoidoscopic procedure,sigmoidoscopic procedures,sigmoidoscopic surgical procedure,procedure, surgical,sigmoidoscopic surgery,procedures, surgical,sigmoidoscopic surgery,sigmoidoscopic surgeries,sigmoidoscopic surgeries,
mastalgia	mastodynias,breast pain,breast pains,breast pain,breast pains,mammalgia,mammalgias,mastalgia,mastalgias,
hyperactivity	
anisakis	
vldl	
nutrient-dense	
tabouli	
cough	
chickpeas	
strawberries	
iritis	
phosphorus	
estragole	
vagina	
uti	
dehydroepiandrosterone	
c-erbb2	
sustainability	program evaluation,program evaluations,program evaluations,program sustainability,program sustainabilities,program sustainabilities,program sustainability,program effectiveness,program effectiveness,family planning program evaluation,program appropriateness,program appropriateness,
dentist	
mucus	
botulism	
nepal	
harvard	
laughter	
cantaloupe	cucumis melos,cucumis melos,cantaloupes,cantaloupe,
soup	lysyl-glycyl-aspartyl-glutamyl-glutamyl-seryl-leucyl-alanine,lys-gly-asp-glu-glu-ser-leu-ala,
patent	
isoflavones	
asbestos	
cocaine	
glyburide	
tangeretin	
pbcs	
smoking	
cross-contamination	
tufts	
cirrhosis	
precose	bay g 5421,glumida,precose,glucor,prandase,glucobay,
sauerkraut	
barley	
hernia	
mango	mangiferas,mangifera indica,mangifera indicas,mangifera indicas,mango,mangos,
adulterant	
orange	
beriberi	
painkillers	
biopsy	
pumpkin	
b12	
hypospadias	hypospadia,
raspberries	
dvd	
seitan	
lobotomy	psychosurgeries,lobotomy,lobotomies,gyrectomy,gyrectomies,leukotomy,leukotomies,leucotomy,leucotomies,topectomy,topectomies,
cholesterol	
polyradiculoneuropathy	
zingerone	vanillylacetone,4-(4-hydroxy-3-methoxyphenyl)butan-2-one,0 paradol,vanillyl acetone,
metabolife	
pentagon	
antioxidant	
endometriosis	
hownottodie	
platelets	
metamucil	metamucil,plantaglucide,ispaghule gum,ispaghule gum,plantago seed,plantago seed,ispaghula,isogel,reguval,
pinapples	
millet	
burping	
mangoes	mangiferas,mangifera indica,mangifera indicas,mangifera indicas,mango,mangos,
roundup	
postmenopausal	
insulin	
manure	
alzheimer's	
bananas	
thyme	thymus plant,thymus plants,thymus plants,thymus vulgaris,thymus vulgari,thymus vulgaris,thyme,thymes,
greece	macedonia (greece),crete,
superbugs	
plants	
tetrahydroisoquinoline	
mit	
carrots	
beeturia	
dioxin	
fish	
gingerols	
lecithin	
ibs	
mrsa	
papaya	
nutrasweet	methyl aspartylphenylalanine,methyl aspartylphenylalanine,aspartylphenylalanine methyl ester,ester, methyl,canderel,hermesetas gold,hermesetas gold,milisucre,tri-sweet,tri sweet,trisweet,nozucar,nutrasweet,sc-18862,sc 18862,sc18862,goldswite,
veggiecation	
wool	
abortion	
glaucoma	
cadavers	
wrinkles	skin aging,solar aging of skin,photoaging of skin,skin wrinkling,skin wrinklings,skin wrinkling,
auraptene	auraptene,7-geranyloxycoumarin,
glycotoxins	
infections	
tobacco	
california	
mesquite	
chestnuts	
kiwifruit	
seeds	
coumarin	
spermine	
vioxx	
anemia	
quinoa	
nausea	
hunger	
folate	
korea	
ractopamine	4-hydroxy-alpha-(((3-(4-hydroxyphenyl)-1-methylpropyl)amino)methyl)benzenemethanol,ractopamine hydrochloride,ly 031537,ly-031537,el 737,el-737,
thyroid	
nuts	
prebiotics	prebiotic,
expec	extraintestinal pathogenic e. coli,expec,
thymus	
potatoes	
cost-effective	
broccoli	broccoli,brussel sprout,kale,cauliflower,collard green,collard greens,cabbage,cabbages,
x-rays	
nitrate	
burritos	
lasers	
apple	
chlorella	
nitroglycerin	
reflux	
hormesis	hormeses,hormetic dose-response,hormetic dose-response,hormetic dose-responses,hormetic dose response,hormetic dose-responses,
rowanberries	
organic	
watercress	nasturtiums,nasturtium officinale,nasturtium officinales,nasturtium officinales,rorippa nasturtium-aquaticum,rorippa nasturtium aquaticum,rorippa nasturtium-aquaticums,rorippa nasturtium-aquaticum,
cadaverine	
preservatives	
antidepressants	
liposuction	lipectomies,aspiration lipectomy,aspiration lipectomies,aspiration lipectomies,aspiration lipectomy,aspiration lipolysis,aspiration lipolysis,suction lipectomy,suction lipectomies,suction lipectomy,suction lipectomies,suction lipolysis,suction lipolysis,liposuction,liposuctions,lipoplasty,lipoplasties,
arrhythmias	
carrageenan	
parasites	
cranberry	
ireland	
iga	
mouthwash	
goitrogens	
phytochemicals	phytonutrient,dietary phytochemicals,dietary phytochemicals,phytonutrients,plant-derived compounds,plant-derived compounds,plant derived compounds,phytochemical,plant-derived chemicals,plant-derived chemicals,plant derived chemicals,
peanuts	
preparation	
colibacillosis	e infections,escherichia infections,escherichia coli infection,escherichia infection,e coli infections,e coli infection,e infection,
alfalfa	
beets	
neurotransmitters	
supermarkets	
eggplant	solanum melongenas,solanum melongena,aubergine,aubergines,eggplant,eggplants,brinjal,brinjals,
maimonides	
microparticles	cell derived microparticles,cell-derived microparticle,cell-derived microparticle,ectosomes,ectosome,cell-derived microparticles,cell microparticles,shedding microvesicles,shedding microvesicle,shedding microvesicles,shedding microvesicle,cell membrane microparticles,cell membrane microparticle,microparticle, membrane,microparticles, membrane,cell microparticle,cell microparticles,circulating cell-derived microparticles,microparticle, cell-derived,microparticles, cell-derived,circulating cell derived microparticles,circulating cell-derived microparticle,circulating microparticle,circulating microparticles,
grilling	
mammals	
lemonoids	
h√§agen-dazs	
prevotella	
breakfast	breakfasts,breakfast time,breakfast times,breakfast time,breakfast times,morning meal,morning meal,morning meals,morning meals,
rickets	
pritikin	
spain	
chervil	
boiled	furunculoses,boils,furuncles,furuncle,
n-hexacosanol	hexacosyl alcohol,n-hexacosanol,aluminum 1-hexacosanol,
birds	
phytonutrient	phytonutrient,dietary phytochemicals,dietary phytochemicals,phytonutrients,plant-derived compounds,plant-derived compounds,plant derived compounds,phytochemical,plant-derived chemicals,plant-derived chemicals,plant derived chemicals,
choline	
fungicides	
beans	
abortifacient	
impotence	
europe	
pyrogallol	
juice	
hepatitis	
dioxins	
phytosterols	
petunidin	
breastfeeding	breast feeding,breastfeeding,feeding, breast,exclusive breast feeding,exclusive breastfeeding,exclusive breastfeeding,
msg	
desserts	
rutabagas	
vegetarians	
fertility	
post-menopause	postmenopausal period,postmenopausal period,post-menopause,post menopause,post-menopauses,post-menopausal period,post-menopausal period,post menopausal period,
mastectomy	
omnivores	
downers	
wakame	wakame,undaria pinnatifida,
polyps	
irritability	irritable mood,irritable moods,irritable moods,
viruses	
benzodiazepines	
tylenol	acetominophen,hydroxyacetanilide,apap,p-acetamidophenol,p-hydroxyacetanilide,paracetamol,n-(4-hydroxyphenyl)acetanilide,acetamidophenol,n-acetyl-p-aminophenol,acephen,acetaco,tylenol,anacin-3,anacin 3,anacin3,datril,panadol,acamol,algotropyl,
prostaglandin	
qaly	year, life,years, life,quality-adjusted life year,quality-adjusted year,quality-adjusted years,quality adjusted life years,qaly,healthy years equivalents,healthy equivalents,healthy years equivalent,adjusted life years,adjusted life year,year, life,years, life,adjusted year,adjusted years,
anti-inflammation	
accidents	
spearmint	
diarrhea	
arthritis	
mat√©	
detoxification	
mangosteen	garcinia mangostanas,garcinia mangostana,mangosteen,mangosteens,
steak	
death	
mercury	
eeg	
lipitor	atorvastatin calcium,atorvastatin calcium trihydrate,trihydrate, calcium,atorvastatin trihydrate,calcium atorvastatin,calcium salt atorvastatin,atorvastatin calcium hydrate,hydrate, calcium,atorvastatin hydrate,atorvastatin calcium anhydrous,atorvastatin anhydrous,anhydrous, calcium,atorvastatin,ci 981,ci-981,ci981,lipitor,liptonorm,
blood-letting	
bacteriophage	
cosmetics	
pneumonia	
chomorro	
idaho	
horsemeat	
pre-diabetes	prediabetic states,prediabetic state,prediabetic states,prediabetes,
pecan	caryas,hickory tree,hickory trees,hickory tree,hickory trees,pecans,pecan,hickory nuts,hickory nut,hickory nut,hickory nuts,carya illinoensis,carya illinoenses,carya illinoenses,pecan tree,pecan trees,pecan tree,pecan trees,
oranges	
kimchi	
greens	
bioaccumulation	
microcystins	
carnosine	
urticaria	
gravy	
sweeteners	
interleukin-1	
egg	
fluoride	
texas	
sardines	
dhea	
music	
waistline	
pectin	
sulfur	
dehydration	
cheerios	protein, cheerio,
acetaldehyde	
carbohydrates	
atherosclerosis	
casomorphin	
vincristine	
vietnam	
raw	
insects	
amphetamines	
cocoa	
kraft	
nagasaki	
adolescence	
dementia	
restaurants	
cigarettes	
whortleberries	vaccinium bracteatum,vaccinium bracteatums,vaccinium bracteatum,vaccinium bracteatums,sea bilberry,sea bilberries,sea bilberry,sea bilberries,bilberry,bilberries,whortleberry,whortleberries,
pepto-bismol	subsalicylate bismuth,trigastronol,pepto-bismol,kaopectate,helidac,
ketchup	
boston	
cysticercosis	
amyloidosis	
centrum	
peaches	
pork	
emphysema	
sleep	
toxocara	
fats	
eyeballs	eyes,
vegetarian	
taxol	
paclitaxel	
quercitin	
sardinia	
anti-aromatase	
pineapples	
infertility	
bologna	
migraines	
screening	
affordability	
arginine	
thalidomide	
duck	
anosmia	
weeds	
lavender	
leucine	
xenobiotics	
antiemetic	
egcg	
phytoestrogens	
arsenic	
hyperpigmentation	
canada	
tofu	soy food,soy foods,soy food,natto,soy cheese,soy cheese,soy cheeses,soy cheeses,tempeh,texturized soy protein,texturized protein,texturized proteins,protein, soy,proteins, soy,texturized soy proteins,texturized vegetable protein,texturized protein,protein, vegetable,proteins, vegetable,tofu,curd, bean,curds, bean,soy curd,soy curds,soy bean curd,soy bean curds,miso,soy sauce,soy sauce,
sedatives	
claudication	
semen	
vaccines	
lactose	
billberries	
steviol	
sarcocystis	
melqx	
happiness	happinesses,
pasta	
scope	
anovulatory	
rice	
environment	
doughnuts	
tapeworms	
carnitine	
endocannabinoids	endocannabinoid,
ulcers	
popcorn	inhibitor, popcorn,corn inhibitor of activated hageman factor,
cilantro	coriandrums,coriander,corianders,cilantro,cilantros,coriandrum sativum,coriandrum sativums,coriandrum sativums,
cumin	
phosgene	
halitosis	halitoses,
muscles	
epa	
neurocysticercosis	neurocysticercoses,central cysticercosis,central nervous system cysticercosis,brain cysticercosis,brain cysticercosis,
bergamottin	5-geranoxypsoralen,8-geranyloxypsoralen,
firmicutes	
eggs	
cetuximab	
mutagens	
alkylphenols	
jalapeno	bell pepper,bell peppers,bell pepper,bell peppers,sweet pepper,sweet pepper,sweet peppers,sweet peppers,red pepper,red pepper,red peppers,red peppers,green pepper,green peppers,green pepper,green peppers,cayenne pepper,cayenne peppers,cayenne pepper,cayenne peppers,cayenne,paprika,hot pepper,hot peppers,hot pepper,hot peppers,jalapeno pepper,jalapeno peppers,jalapeno pepper,jalapeno peppers,pimiento,capsicum annuum,chilli pepper,chilli peppers,chilli pepper,chilli peppers,chile pepper,chile peppers,chile pepper,chile peppers,chili pepper,chili peppers,chili pepper,chili peppers,
yeast	
chamomile	
opiate	
apes	
tarragon	artemisias,sagewort,sageworts,sagebrush,sagebrushs,levant wormseed,levant wormseed,levant wormseeds,levant wormseeds,mugwort,mugworts,wormwood,wormwoods,artemisia capillaris,artemisia capillari,artemisia capillari,artemisia capillaris,artemisia dracunculus,tarragon plant,tarragon plant,tarragon plants,tarragon plants,artemisia maritima,artemisia maritimas,artemisia maritimas,artemisia vulgaris,artemisia vulgari,artemisia vulgaris,artemisia abrotanum,artemisia abrotanums,artemisia abrotanums,southernwood,southernwoods,artemisia judaica,artemisia judaicas,artemisia judaica,
psoriasis	
sinusitis	
jama	
astrocytes	
ubiquinol	
roselle	hibiscus sabdariffa,roselle,roselles,hibiscus cannabinus,kenaf,
saffron	
anti-inflammatory	
viagra	sildenafil citrate,citrate 1-((3-(67-dihydro-1-methyl-7-oxo-3-propyl-1h-pyrazolo(43-d)pyrimidin-5-yl)-4-ethoxyphenyl)sulfonyl)-4-methylpiperazine,ncx-911,ncx 911,ncx911,revatio,sildenafil,uk 92480-10,uk 92480 10,uk 9248010,uk-92,480-10,92,480 uk,homosildenafil,hydroxyhomosildenafil,viagra,acetildenafil,sildenafil lactate,sildenafil lactate,sildenafil nitrate,sildenafil nitrate,desmethyl sildenafil,desmethyl sildenafil,desmethylsildenafil,
insecticides	
lasik	laser-assisted stromal in situ keratomileusis,laser assisted stromal in situ keratomileusis,laser intrastromal keratomileusis,keratomileuses, intrastromal,keratomileusis, intrastromal,laser intrastromal keratomileuses,laser in situ keratomileusis,lasik,
television	televisions,
alpha-gal	
neurotoxins	
tacos	coronin protein,protein, coro1a,coronin p57,protein, coronin-1,actin coronin,protein, taco,protein, coro1a,actin coronin,aspartate tryptophane,protein, taco,protein, coro1b,2 coronin,actin coronin,protein, coro1b,2 coronin,1b coronin,actin coronin,protein, coro1c,1c coronin,actin-binding coronin-like,coronin-like actin-binding protein 1c,actin coronin,protein, coro1c,3 coronin,1c coronin,actin coronin,protein, coro2a,actin coronin,protein, ir10,protein, coro2a,4 coronin,2a coronin,actin coronin,protein, coro7,7 coronin,protein, coro7,7 coronin,1a coronin,protein, coro1a,protein, coronin-1,1 coronin,protein, crn1,1 coronin,protein, ylr429w,protein, coro,protein, coronin,
mevacor	
grains	
zeaxanthin	
enterotypes	
mushrooms	
predimed	
microalbuminuria	diabetic nephropathies,diabetic nephropathy,diabetic nephropathy,diabetic kidney disease,diabetic kidney diseases,disease, kidney,diseases, kidney,diabetic glomerulosclerosis,kimmelstiel-wilson syndrome,kimmelstiel wilson syndrome,kimmelstiel-wilson syndrome,kimmelstiel-wilson disease,kimmelstiel wilson disease,nodular glomerulosclerosis,nodular glomerulosclerosis,diabetic glomerulosclerosis,intracapillary glomerulosclerosis,
acne	
gastroenteritis	
meditation	transcendental meditation,transcendental meditation,
hemorrhoids	hemorrhoid,
uruguay	
internship	
epilepsy	
spinach	
spirulina	arthrospira,arthrospira maxima,spirulina maxima,
laxatives	
barberries	
flexitarians	
psychosis	
diverticulosis	
brains	
scurvy	scurvies,hypoascorbemia,hypoascorbemias,scorbutus,
eczema	
putrescine	
belgium	
pregnant	
swordfish	
thrifty	
treadmills	exercise tests,exercise test,exercise tests,arm ergometry test,arm ergometry tests,test, ergometry,tests, ergometry,arm test,arm tests,bicycle ergometry test,bicycle ergometry tests,test, ergometry,tests, ergometry,bicycle test,bicycle tests,fitness testing,fitness testings,fitness testing,fitness testings,step test,step tests,step test,step tests,stress test,stress tests,stress test,stress tests,treadmill test,treadmill test,treadmill tests,treadmill tests,physical fitness testing,testing, fitness,testings, fitness,physical fitness testings,physical testing,physical testings,cardiopulmonary exercise test,cardiopulmonary exercise tests,test, exercise,tests, exercise,cardiopulmonary test,cardiopulmonary tests,
als	
pancakes	
mcdonalds	
osteoporosis	
pcbs	
ama	
ginger	
splenda	1,6-dichloro-1,6-dideoxy-beta-d-fructofuranosyl-4-chloro-4-deoxy-alpha-d-galactopyranoside,trichlorogalactosucrose,trichlorogalacto-sucrose,1',4',6'-trichloro-1',4,6'-trideoxygalactosucrose,sucralose,splenda,
kangaroos	
uranium	
spices	
elderly	
patulin	
sorbitol	
weakness	
telomerase	
chlorhexidine	
resveratrol	
warts	
endothelium	
poultry	
peppers	
seaweed	macroalgae,
cannabis	
rabies	
autism	
gynecomastia	
freeze-dried	freeze drying,freeze dryings,freeze dryings,lyophilization,lyophilizations,
appetite	
fukushima	
octopus	
pease	
zerumbone	
cheese	
catfish	
oxford	
flatulence	flatus,
pears	
cake	
protein	
jam	
chemicals	
tamoxifen	
pregnancy	
barbecuing	
eye	
shortening	
turkey	
pasteurization	pasteurizations,ultrapasteurization,ultrapasteurizations,
cataracts	
osteoarthritis	
peptides	
atkins	atkin-flaitz syndrome,mental retardation x-linked atkin type,retardation mental,mrx21,retardation, mental,retardation, mental,mental x-linked,retardation, mental,atkin flaitz patil smith syndrome,retardation, mental,
cookies	
angiography	
morphine	
fruits	
leeks	
endothelial	
beverage	
aspirin	
watermelon	
cavities	
kids	
diacetyl	
superfood	
pudding	
olives	
tumor	
chili's	bell pepper,bell peppers,bell pepper,bell peppers,sweet pepper,sweet pepper,sweet peppers,sweet peppers,red pepper,red pepper,red peppers,red peppers,green pepper,green peppers,green pepper,green peppers,cayenne pepper,cayenne peppers,cayenne pepper,cayenne peppers,cayenne,paprika,hot pepper,hot peppers,hot pepper,hot peppers,jalapeno pepper,jalapeno peppers,jalapeno pepper,jalapeno peppers,pimiento,capsicum annuum,chilli pepper,chilli peppers,chilli pepper,chilli peppers,chile pepper,chile peppers,chile pepper,chile peppers,chili pepper,chili peppers,chili pepper,chili peppers,
preladenant	sch 420814,sch420814,sch-420814,preladenant,
ergothioneine	thioneine,2-thiol-l-histidine-betaine,2 thiol l histidine betaine,
jazz	
endotoxemia	endotoxemias,
cans	
kohlrabi	seed kohlrabi,9128 t,protein, t-9128,
eggnog	
yams	
grapefruit	citrus x paradisi,grapefruit,grapefruits,toronja,toronjas,
herring	
truvia	
atp	
thimerosal	sodium ethylmercurithiosalicylate,sodium ethylmercurithiosalicylate,thiomersalate,mercurothiolate,thiomersal,vitaseptol,merthiolate,
nicotine	
mold	
digoxin	
lutein	
underweight	leanness,underweight,
myelopathy	
acetaminophen	
volunteer	
eudaemonia	
endorphins	
yale	
wartime	
pneumovax	
blind	
gingivitis	
mood	
ssri's	
alli	
book	
indigestion	dyspepsias,indigestion,indigestions,
lipstick	
lupus	
hummus	
pizza	protein, at4g31910,protein, piz,
xeno-autoantibodies	
headaches	
wisconsin	
hives	urticarias,hives,
fructose	
newborns	
pharmaceuticals	
ecmo	ecmo treatment,ecmo treatments,ecmo treatment,ecmo treatments,extracorporeal oxygenation,extracorporeal membrane oxygenations,oxygenation, membrane,oxygenations, membrane,extracorporeal oxygenations,extracorporeal life support,extracorporeal life supports,support, life,supports, life,extracorporeal support,extracorporeal supports,ecls treatment,ecls treatments,ecls treatment,ecls treatments,
contamination	
ischemia	
mouth	
artichokes	
african	
israel	
colon	
risk	
melatonin	
athletics	
guava	
rye	
glycoalkaloids	leptine 1,
heartbeat	
bluefish	
ammonia	
taxes	
fodmaps	
fat	
frying	
lovastatin	
dizziness	
pcos	
liver	
suicide	
epic	
veal	
pollutants	
chickens	
colic	
chocolate	
belladonna	
exercise	
algae	
fever	
sunburn	sunburns,
babies	
pcrm	
biomagnification	
cooking	
sarcopenia	sarcopenias,
stress	
fda	
crisco	
aromatase	
vegan	
glycogen	
bargains	
mexico	
nasa	nasa,national aeronautics and space administration,
cats	
perfluorochemicals	
uganda	republic of uganda,
dairy	
homeopathy	homoeopathy,
plaque	
ki-67	
aricept	
kombu	laminarias,laminaria japonica,laminaria japonicas,laminaria japonicas,kombu,kombus,laminaria tents,laminaria tent,laminaria tent,laminaria tents,
schizophrenia	
lindane	
menopause	
snacks	snack,snack food,snack food,snack foods,snack foods,snacktime,snacktimes,snacking,
gerd	gastric acid reflux,reflux, acid,gastric reflux,gastric acid reflux disease,gastro-esophageal reflux,gastro esophageal reflux,gastro-esophageal reflux,gastroesophageal reflux disease,gerd,gastroesophageal reflux,esophageal reflux,gastro-oesophageal reflux,gastro oesophageal reflux,gastro-oesophageal reflux,
england	
addiction	
usda	usda,united states. dept. of agriculture,department of agriculture (u.s.),
rooibos	aspalathus linearis,rooibos,rooibo,
nutrition	
lycopene	
cereal	
lactation	
plant-based	
neuropathy	
sugar	
whr	
adiponectin	
aneurysm	
malaria	
endurance	
herbs	
berberine	
peanut	
diet	
microgreens	
sheep	
butter	
alpha-carotene	(6'r)-isomer alpha-carotene,
kingdom	
azarcon	
bacteroides	
lipotoxicty	
purines	
vegf	
depression	
gelatin	
boron	
angina	
blueberries	blueberry plant,blueberry plants,blueberry plant,vaccinium virgatum,vaccinium ashei,vaccinium uliginosum,vaccinium angustifolium,blueberry,blueberries,vaccinium corymbosum,
arteries	
neu5gc	
zsweet	
hamburger	
amalika	
mackerel	croakers,croaker,mackerels,mackerel,sunfishes,centrarchidae,porgies,sparid fish,sparid fish,sparus,bluegill,bluegills,dolphin fish,mahi-mahi,
venison	
capsaicin	
oklahoma	
mozart	
leprosy	
recipes	
autophagy	
cyclamate	
peach	
sweetener	
salsa	
hijiki	
bbq	10-cl-bbq,
symptoms	
plastic	
boiling	furunculoses,boils,furuncles,furuncle,
pancreatitis	
acromegaly	
hawthorn	
appendicitis	ruptured appendicitis,ruptured appendicitis,perforated appendicitis,perforated appendicitis,
virus	
anesthesia	
histones	
salmonella	
selenium	
istradefylline	8-(2-(3,4-dimethoxyphenyl)ethenyl)-1,3-diethyl-3,7-dihydro-7-methyl-1h-purine-2,6-dione,kw 6002,kw-6002,
wheat	
pretzels	
adipocytes	
seafood	seafoods,sea-food,sea food,sea-foods,
onions	
jobs	
medicine	
kelp	
eggbeaters	
adhd	attention deficit disorders with hyperactivity,attention deficit hyperactivity disorders,attention deficit-hyperactivity disorder,attention deficit-hyperactivity disorders,disorder, deficit-hyperactivity,disorders, deficit-hyperactivity,attention disorder,attention disorders,hyperkinetic syndrome,hyperkinetic syndromes,addh,attention deficit hyperactivity disorder,attention deficit disorder,attention deficit disorders,disorder, deficit,disorders, deficit,attention disorder,attention disorders,dysfunction, brain,minimal dysfunction,minimal brain dysfunction,
fennel	
sulforaphane	(r)- sulforaphane,methylsulfoxybutylisothiocyanate,1-isothiocyanato-4-methylsulphinylbutane,sulphoraphane,4-methylsulphinylbutyl glucosinolate,sulforaphane,
propulcid	
endive	
detox	
nitrates	
baking	
chernobyl	
japanese	
france	
antibodies	
after-surgery	
aspartame	
anxiety	
roasting	
colectomy	colectomies,
diacylglycerol	
deer	
dieldrin	
bloating	
butyrate	
goose	
adulterated	
zucchini	
india	
hesperidin	
judaism	jewish ethics,jewish ethic,jewish ethics,jewish ethic,
lemon	
oils	
bha	
whiting	hakes,hake,macrouridae,grenadiers,grenadier,gadidae,cods,
burgers	
homocysteine	
valium	7-chloro-1,3-dihydro-1-methyl-5-phenyl-2h-1,4-benzodiazepin-2-one,diazemuls,faustan,valium,seduxen,sibazon,stesolid,apaurin,relanium,
prediabetes	
lemongrass	
acarbose	
lymphoma	
amphetamine	
chlorophyll	
chewing	
stroke	
rash	
fragrance	
beethoven	
cashews	
tetrodotoxin	
turnips	
tamsulosin	5-(2-((2-(2-ethoxyphenoxy)ethyl)amino)propyl)-2-methoxybenzenesulfonamide,ly 253352,ly-253352,ym 617,ym-617,flomax,tamsulosin hydrochloride,
worms	
carob	
poland	
piperine	
cycling	
phytosterol	
sulfites	
dressings	
fatigue	
cranberries	
apigen	
scallops	scallops,scallop,chlamys,chlamy,patinopecten,patinopectens,
clams	
limes	
zinc	
placebo	
agribusiness	
phip	
leptin	
sle	
amyloid	
radicchio	cichorium intybus,
applebee's	
sids	
acetate	
peoria	
pathogens	
ftc	
inflammation	
italy	
finland	√•land islands,aland islands,
centenarians	oldest old,nonagenarians,nonagenarian,octogenarians,octogenarian,centenarians,centenarian,
organochlorines	
bread	
fibroids	
oxidation	
paella	
gnathostomiasis	gnathostomiases,gnathostoma infection,gnathostoma infections,gnathostoma infection,gnathostoma infections,
bacon	
parkinson‚Äôs	
lipotoxicity	
kale	
precancerous	
bmi	
leukemia	
cryptoxanthin	
estrogen	
mgus	gammapathies, monoclonal,benign monoclonal gammapathies,benign monoclonal gammapathy,benign gammapathies,benign gammapathy,gammapathy, monoclonal,gammopathies, monoclonal,benign monoclonal gammopathies,benign monoclonal gammopathy,benign gammopathies,benign gammopathy,gammopathy, monoclonal,monoclonal gammapathy of undetermined significance,
anger	
cardamom	elettarias,cardamom,cardamoms,cardamon,cardamons,amomum cardamomum,amomum cardamomums,amomum cardamomums,elettaria cardamomum,elettaria cardamomums,elettaria cardamomum,
cance	
placebos	
mutations	
enemas	
sushi	
soy	
deafness	
avocado	perseas,persea americana,persea americanas,persea americana,avocado,avocados,
stevia	
biomarkers	biological markers,biologic markers,biologic markers,biologic marker,biologic marker,biological marker,biological marker,biological markers,laboratory markers,laboratory markers,laboratory marker,laboratory marker,serum markers,serum markers,serum marker,serum marker,surrogate endpoints,surrogate endpoints,surrogate end points,points, end,surrogate end point,point, end,surrogate endpoint,surrogate endpoint,clinical markers,clinical markers,clinical marker,clinical marker,viral markers,viral markers,viral marker,viral marker,biochemical marker,biochemical markers,biochemical markers,biochemical marker,immunologic markers,immune markers,immune markers,immunologic marker,immunologic markers,immune marker,immune marker,immunologic marker,surrogate markers,surrogate markers,surrogate marker,surrogate marker,
roots	
antarctica	
daniel	disease, residual,minimal disease,minimal diseases,minimal residual diseases,diseases, residual,residual neoplasm,residual neoplasms,residual neoplasms,disease, minimal,residual disease,residual diseases,diseases, minimal,residual minimal disease,residual minimal diseases,minimal residual disease,residual cancer,residual cancer,residual cancers,residual cancers,residual tumor,residual tumors,residual tumor,residual tumors,
bioavailability	biological availability,biological availabilities,biological availabilities,biologic availability,physiologic availability,biologic availability,biologic availabilities,biologic availabilities,bioavailability,bioavailabilities,physiologic availability,physiologic availabilities,physiologic availabilities,availability equivalency,availability equivalencies,availability equivalencies,availability equivalency,
pistachios	
dyspepsia	dyspepsias,indigestion,indigestions,
anhedonia	anhedonias,social anhedonia,social anhedonia,social anhedonias,social anhedonias,physical anhedonia,physical anhedonia,physical anhedonias,physical anhedonias,
tetracycline	
oregon	
flavonoids	
potassium	
guacamole	
candy	candies,confection,confections,
obesogens	
phytoestrogen	
premarin	conjugated estrogens,hormones, estrogenic,conjugated estrogenic hormones,conjugated estrogens,substances, estrogenic,conjugated estrogenic substances,congest,conjugated equine estrogens,estrogens, equine,dagynil,oestrofeminal,oestro-feminal,oestro feminal,estro-feminal,estro feminal,premarin,climopax,climarest,presomen,progens,transannon,femavit,carentil,prelestrin,
egg-free	
preservation	
bpa	
adrenaline	
levodopa	
prozac	fluoxetin,n-methyl-gamma-(4-(trifluoromethyl)phenoxy)benzenepropanamine,lilly-110140,lilly 110140,lilly110140,sarafem,fluoxetine hydrochloride,prozac,
gangrene	
hazelnuts	
bph	
propionate	
phenolics	
cretinism	
harmane	
sports	
miscarriage	
carcinogen	
lemons	
tingling	
walnut	
tumors	
radiation	
ph	
mesclun	
pheasants	
convenience	
hershey‚Äôs	
serotonin	
rhabdomyolysis	
apricots	
alcohol	
hiccups	hiccups,hiccough,hiccoughs,
std	
iq45b	
monsanto	mon-0585,monsanto 585,2,6-di-t-butyl-4-(alpha,alpha-dimethylbenzyl)phenol,
blindness	
asthma	
australia	
capers	
bse	
doctors	
placenta	
dosage	
cspi	
enzymes	
allspice	
manganese	
sun	
polyamine	
ornish	
ceramide	
variety	
copper	
iodine	
mesothelioma	
catechins	
kfc	protein, kfc,
tranquilizers	
mortality	
thorazine	thorazine,aminazine,largactil,chlordelazine,chlorpromazine hydrochloride,chlorpromazine hydrochloride,contomin,fenactil,propaphenin,chlorazine,
persin	1-acetyloxy-2-hydroxy-12,15-heneicosadien-4-one,(z,z)-1-acetyloxy-2-hydroxy-12,15-heneicosadien-4-one,s-(z,z)-isomer persin,r-(z,z)-isomer persin,
mcdonald's	
polyphenols	
nsrc	
urine	
sucralose	1,6-dichloro-1,6-dideoxy-beta-d-fructofuranosyl-4-chloro-4-deoxy-alpha-d-galactopyranoside,trichlorogalactosucrose,trichlorogalacto-sucrose,1',4',6'-trichloro-1',4,6'-trideoxygalactosucrose,sucralose,splenda,
ayurveda	ayurvedic medicine,siddha medicine,siddha medicine,hindu medicine,hindu medicine,
buttermilk	butter milk,butter milk,
amla	phyllanthus emblicas,phyllanthus emblica,emblica officinalis,emblica officinali,emblica officinali,mirobalanus embilica,mirobalanus embilicas,mirobalanus embilicas,amla,amlas,
endostatin	
longevity	
seizures	
aids	
cadbury	
dentists	
galactose	
taiwan	
rhubarb	rhubarb,rheum officinale,da huang,da huang,chinese rhubarb,chinese rhubarb,rheum rhaponticum,rheum tanguticum,
aromatherapy	aromatherapies,aroma therapy,aroma therapies,aroma therapies,aroma therapy,
eco-atkins	
pbdes	
grapes	
foxglove	
cold	
diabeta	glybenclamide,glibenclamide,diabeta,euglucon 5,neogluconin,hb-419,hb 419,hb419,hb-420,hb 420,hb420,maninil,micronase,daonil,euglucon n,
cola	
pop-tarts	
honey	
gas	
lies	
morbidity	
hawaii	midway island,midway islands,
calories	
almonds	
angiograms	angiographies,angiogram,angiograms,arteriography,arteriographies,
bladder	
steroids	
hormone-disruptors	endocrine disruptors,endocrine disrupting chemicals,endocrine chemicals,endocrine disruptor effect,effect, disruptor,endocrine effect,endocrine disruptor effects,effects, disruptor,endocrine effects,
yogurt	yoghurt,
twinkies	
noni	morindas,morinda citrifolia,morinda citrifolias,morinda citrifolias,noni,nonus,
cornell	
physicians	
endotoxins	
interns	
children	
menstruation	
kissing	
teeth	
sprouts	
diverticulitis	
radioactivity	radioactivities,radioactive disintegration,radioactive disintegration,radioactive disintegrations,radioactive disintegrations,nuclear decay,nuclear decay,
cyanopsia	
mioscene	
lettuce	
coma	
hormones	
ciguatera	ciguatera poisonings,ciguatera poisoning,ciguatera poisonings,ciguatera fish poisoning,ciguatera fish poisonings,ciguatera poisoning,ciguatera poisonings,ciguatera,
telomeres	
douching	
copd	
naproxen	
flax	
coca-cola	
organotins	organotin compounds,
igf-1	
carcinogens	
riboflavin	
grapefruits	citrus x paradisi,grapefruit,grapefruits,toronja,toronjas,
transglutaminase	
aggression	aggressions,
mptp	
lead	
apnea	
amputations	
sunlight	sunshine,
vitamins	
antacids	
multivitamins	
torcetrapib	
endotoxin	
anesthetic	
corn	
cherries	
hysterectomy	
blackberries	rubus glaucus,andean blackberry,andean blackberries,andean blackberries,andean blackberry,rubus idaeus,raspberries,raspberry,rubus fruticosus,blackberries,blackberry,
pro-oxidants	species, oxygen,active oxygen,active oxygen,oxygen radicals,pro-oxidants,pro oxidants,
sausage	
sandwiches	
nori	
antinutrients	
offal	
thermogenics	
sage	
slovakia	slovak republic,
massage	
obesity	
salmon	
netherlands	holland,kingdom of the netherlands,sint maarten,aruba,curacao,
zoonoses	zoonotic infectious diseases,zoonotic disease,zoonotic diseases,disease, infectious,diseases, infectious,zoonotic infectious disease,zoonotic diseases,zoonotic disease,zoonotic diseases,zoonotic disease,zoonotic infections,zoonotic infection,zoonotic infections,zoonotic infection,
lorazepam	
licorice	
plutonium	
cupcakes	
nitrosamines	
theanine	
citrulline	
tuna	
fructans	
cauliflower	
smithfield	
shrimp	
buddhists	buddhist ethics,buddhist ethic,buddhist ethic,buddhist ethics,
sirtuins	
hepatotoxins	
aneurism	
tums	
kiwis	
glucocorticoids	
chick-fil-a	
microcephaly	
oats	avenas,oats,oat,avena sativa,cultivated oat,cultivated oats,cultivated oat,cultivated oats,
cognition	
mitochondria	
benzene	
nauseous	
statins	
roasted	
concussions	